Start,End,StartM,EndM,length,lengthM,iid,ch,StartPosGRCh37,EndPosGRCh37
3411,3699,0.17839301,0.191397,288,0.01300399000000002,Ust_Ishim_published.DG,2,6725121,7213141
10806,11947,0.455731,0.485975,1141,0.030243999999999993,Ust_Ishim_published.DG,2,21936060,25135620
20863,21351,0.71030003,0.72687399,488,0.01657396,Ust_Ishim_published.DG,2,45013538,45849003
31394,31817,0.94669002,0.95762599,423,0.010935970000000017,Ust_Ishim_published.DG,2,68174571,69069905
49774,50936,1.44240701,1.46718299,1162,0.02477598000000003,Ust_Ishim_published.DG,2,125858376,129065289
53985,54588,1.56408703,1.57644105,603,0.012354019999999855,Ust_Ishim_published.DG,2,137404246,138717751
54718,55617,1.57922006,1.59710598,899,0.01788592000000011,Ust_Ishim_published.DG,2,139070490,141418247
67526,67820,1.88909304,1.90011001,294,0.011016970000000015,Ust_Ishim_published.DG,2,174452807,175133375
73255,73620,2.01463008,2.03084397,365,0.016213889999999953,Ust_Ishim_published.DG,2,192009310,192794059
75660,76455,2.08419704,2.09639502,795,0.012197980000000275,Ust_Ishim_published.DG,2,200567136,202803860
79879,80123,2.18835807,2.20117593,244,0.012817859999999737,Ust_Ishim_published.DG,2,212346739,212886000
80565,81257,2.21327496,2.22403502,692,0.01076005999999996,Ust_Ishim_published.DG,2,213816631,215629322
86222,86603,2.38033891,2.39098907,381,0.010650159999999964,Ust_Ishim_published.DG,2,226545530,227534511
87984,88368,2.44063902,2.45164299,384,0.011003969999999974,Ust_Ishim_published.DG,2,230453614,231309746
93704,93989,2.67469096,2.68832111,285,0.013630150000000008,Ust_Ishim_published.DG,2,242011330,243040807
