Start,End,StartM,EndM,length,lengthM,iid,ch,StartPosGRCh37,EndPosGRCh37
1193,1628,0.03792,0.056866,435,0.018945999999999998,Ust_Ishim_published.DG,3,2145996,2822150
2088,2780,0.086277,0.108032,692,0.021754999999999997,Ust_Ishim_published.DG,3,3405491,4478417
3973,4294,0.167918,0.183676,321,0.015757999999999994,Ust_Ishim_published.DG,3,6435584,7072238
5669,5984,0.236398,0.247695,315,0.011297000000000001,Ust_Ishim_published.DG,3,9255418,10202884
11459,14036,0.410853,0.488574,2577,0.07772099999999998,Ust_Ishim_published.DG,3,22106715,27923781
17062,17858,0.58326799,0.59868902,796,0.015421030000000058,Ust_Ishim_published.DG,3,34822115,36829980
25204,26098,0.73871601,0.756347,894,0.017630990000000013,Ust_Ishim_published.DG,3,56920880,59354454
30954,31347,0.90078402,0.91135001,393,0.010565990000000025,Ust_Ishim_published.DG,3,67354466,68286463
36147,37248,1.06295705,1.07666099,1101,0.013703939999999859,Ust_Ishim_published.DG,3,80536378,85485889
40209,41437,1.11619401,1.14534903,1228,0.02915501999999992,Ust_Ishim_published.DG,3,100213778,104010489
44858,45556,1.22179306,1.23804104,698,0.01624797999999994,Ust_Ishim_published.DG,3,112463310,114104227
76319,76765,2.1767149,2.19847107,446,0.021756170000000186,Ust_Ishim_published.DG,3,194358054,195547195
