Start,End,StartM,EndM,length,lengthM,iid,ch,StartPosGRCh37,EndPosGRCh37
3714,4079,0.211184,0.227056,365,0.015871999999999997,Ust_Ishim_published.DG,1,9535303,10850844
5429,5778,0.30268899,0.31704101,349,0.014352020000000021,Ust_Ishim_published.DG,1,14523337,15145166
9980,10344,0.49129301,0.50193,364,0.010636990000000013,Ust_Ishim_published.DG,1,24535011,25333899
12174,12664,0.56205201,0.57771701,490,0.01566499999999993,Ust_Ishim_published.DG,1,31012257,32171846
15065,17044,0.66323602,0.71889597,1979,0.055659950000000014,Ust_Ishim_published.DG,1,38739842,43751977
18455,19165,0.75007099,0.76390201,710,0.013831020000000027,Ust_Ishim_published.DG,1,48184876,50582172
25330,25715,0.939134,0.95086199,385,0.011727990000000021,Ust_Ishim_published.DG,1,64299260,65032745
34873,35477,1.18073702,1.19618404,604,0.015447019999999867,Ust_Ishim_published.DG,1,88873327,90546928
41900,42401,1.36202097,1.38270104,501,0.02068006999999983,Ust_Ishim_published.DG,1,108694369,110418429
43509,43981,1.41721702,1.43008304,472,0.012866019999999923,Ust_Ishim_published.DG,1,112383655,113336905
44839,45704,1.45684195,1.48385203,865,0.027010079999999936,Ust_Ishim_published.DG,1,115943077,117811155
80656,81121,2.49534392,2.51127791,465,0.015933990000000176,Ust_Ishim_published.DG,1,231945373,232686897
85767,86494,2.71632791,2.75495005,727,0.038622140000000194,Ust_Ishim_published.DG,1,241505994,243009389
88309,88901,2.83920407,2.86232209,592,0.023118020000000072,Ust_Ishim_published.DG,1,247141767,249170711
