Start,End,StartM,EndM,length,lengthM,iid,ch,StartPosGRCh37,EndPosGRCh37
438,958,0.018764,0.030386,520,0.011622,Ust_Ishim_published.DG,4,1701317,3377791
1099,1171,0.043714,0.055738,72,0.012024,Ust_Ishim_published.DG,4,3706785,3830988
2543,2763,0.146174,0.157299,220,0.011124999999999996,Ust_Ishim_published.DG,4,6356365,6648263
9598,10173,0.39445701,0.40694299,575,0.012485980000000008,Ust_Ishim_published.DG,4,21719296,23289721
12314,13184,0.49195999,0.51978302,870,0.02782302999999997,Ust_Ishim_published.DG,4,27757391,30437096
14016,14562,0.54477698,0.56582999,546,0.02105301000000004,Ust_Ishim_published.DG,4,32947309,35329616
22174,23937,0.767272,0.81287098,1763,0.04559898000000007,Ust_Ishim_published.DG,4,58197839,64107663
29636,30281,0.94814098,0.96500599,645,0.016865009999999958,Ust_Ishim_published.DG,4,81227042,83008390
31097,31519,0.99886203,1.00936902,422,0.010506990000000105,Ust_Ishim_published.DG,4,84976857,86437055
31706,32387,1.01403105,1.02433205,681,0.010300999999999894,Ust_Ishim_published.DG,4,86817105,88733531
42337,43191,1.27735198,1.28922498,854,0.011873000000000022,Ust_Ishim_published.DG,4,118622573,121342367
43719,44258,1.30410397,1.31777501,539,0.01367104000000019,Ust_Ishim_published.DG,4,122599249,124417350
48468,48970,1.42728496,1.44114399,502,0.013859030000000105,Ust_Ishim_published.DG,4,138541971,139717020
49584,50231,1.46799505,1.48656404,647,0.018568989999999896,Ust_Ishim_published.DG,4,141357916,143029822
61439,61897,1.80644703,1.822083,458,0.015635969999999944,Ust_Ishim_published.DG,4,175433338,176648393
63336,63924,1.882779,1.90383101,588,0.02105201000000001,Ust_Ishim_published.DG,4,180251982,181473982
65296,65640,1.96797097,1.98688304,344,0.018912069999999837,Ust_Ishim_published.DG,4,183896784,184713915
66309,66521,2.01970792,2.029881,212,0.010173079999999945,Ust_Ishim_published.DG,4,185821036,186282359
68003,68253,2.1108849,2.12099099,250,0.01010609000000029,Ust_Ishim_published.DG,4,189379520,189868753
