Start,End,StartM,EndM,length,lengthM,iid,ch,StartPosGRCh37,EndPosGRCh37
2998,3253,0.34246701,0.36024201,255,0.017774999999999985,I2534,2,14021058,15783051
5521,5787,0.51839298,0.53037697,266,0.011983989999999944,I2534,2,29395327,30210861
6310,6444,0.571787,0.58701098,134,0.015223979999999915,I2534,2,33416210,34101940
7751,7982,0.68753701,0.70109302,231,0.013556009999999952,I2534,2,42912493,44047530
8990,9431,0.77341402,0.80066103,441,0.02724700999999996,I2534,2,48019485,51488425
10380,10663,0.86006898,0.87564898,283,0.015580000000000038,I2534,2,59232709,60722040
10867,11041,0.88805097,0.89836103,174,0.01031006000000001,I2534,2,62914811,64987554
15900,16165,1.26206505,1.27863395,265,0.016568899999999998,I2534,2,107595990,109607256
17610,17788,1.39496195,1.40960205,178,0.014640100000000045,I2534,2,121278910,121877608
20649,20799,1.61767304,1.63175797,150,0.014084930000000107,I2534,2,143625922,145214421
20846,21072,1.63657105,1.65389001,226,0.017318960000000105,I2534,2,145807415,148918835
25283,25590,1.99795902,2.01708603,307,0.019127010000000277,I2534,2,188937490,192316038
26768,26899,2.11275911,2.12402797,131,0.01126886000000038,I2534,2,205153119,206257794
28035,28161,2.22964096,2.24343991,126,0.01379895000000042,I2534,2,216157254,216866439
28910,29082,2.30616093,2.322963,172,0.016802070000000224,I2534,2,220794025,221938210
31241,31365,2.51479101,2.52823305,124,0.013442039999999711,I2534,2,235200368,235609487
