Start,End,StartM,EndM,length,lengthM,iid,ch,StartPosGRCh37,EndPosGRCh37
4931,5201,0.46680301,0.49103501,270,0.024231999999999976,I2534,10,24695364,26535838
5768,5945,0.54086202,0.56019402,177,0.019331999999999905,I2534,10,29965410,30777280
6439,6654,0.59095001,0.60427302,215,0.013323010000000024,I2534,10,33944006,35132742
8547,8717,0.80974299,0.82028902,170,0.010546029999999984,I2534,10,57428088,59571437
9981,10197,0.91222697,0.92760903,216,0.015382059999999975,I2534,10,70028052,71376514
11940,12191,1.03408206,1.04671705,251,0.012634990000000013,I2534,10,80097033,80825867
13585,13989,1.14725602,1.17612696,404,0.02887094000000001,I2534,10,89475717,91959144
17922,18077,1.42355704,1.43721402,155,0.013656980000000152,I2534,10,117789456,118493063
20740,20898,1.67120504,1.68150699,158,0.010301949999999893,I2534,10,129683747,130259232
21131,21293,1.71615803,1.733289,162,0.01713097000000019,I2534,10,131078144,131738544
