Start,End,StartM,EndM,length,lengthM,iid,ch,StartPosGRCh37,EndPosGRCh37
3373,3627,0.28789499,0.30509201,254,0.017197020000000007,I2534,11,17089403,18325146
4373,4635,0.38839,0.41794601,262,0.029556009999999966,I2534,11,21689922,24402606
5379,5509,0.473331,0.485199,130,0.01186799999999999,I2534,11,31871538,32573559
5549,5782,0.49081901,0.51380599,233,0.022986980000000046,I2534,11,33392954,34523664
6427,6557,0.56804198,0.57824302,130,0.010201040000000106,I2534,11,37635892,39752958
10048,10259,0.78656799,0.79894799,211,0.012380000000000058,I2534,11,71495700,73004053
10917,11120,0.834791,0.84629297,203,0.011501970000000084,I2534,11,77032307,78669898
11479,11680,0.88201201,0.89828998,201,0.016277970000000086,I2534,11,80470527,82353843
14269,14460,1.09018803,1.10096705,191,0.010779019999999973,I2534,11,103920105,105996410
17735,17910,1.36224306,1.37704396,175,0.014800900000000006,I2534,11,124405426,125179853
18841,18956,1.45195794,1.46283305,115,0.010875109999999966,I2534,11,129453148,130043978
18966,19082,1.46437097,1.475824,116,0.011453029999999975,I2534,11,130088828,130650590
19368,20208,1.50546002,1.58216298,840,0.07670296000000021,I2534,11,131655619,134938847
