Start,End,StartM,EndM,length,lengthM,iid,ch,StartPosGRCh37,EndPosGRCh37
0,164,0.000381,0.012056,164,0.011675000000000001,I2534,5,26366,1157313
560,715,0.052448,0.076629,155,0.024181,I2534,5,2569156,3104201
5116,5349,0.52669001,0.54233098,233,0.015640969999999976,I2534,5,34617774,36034745
5732,5974,0.57946199,0.59513301,242,0.01567101999999998,I2534,5,38708578,40477515
8252,8407,0.72760302,0.737701,155,0.010097980000000062,I2534,5,65213108,66200248
9078,9213,0.81268001,0.82343501,135,0.010754999999999959,I2534,5,72840673,73506784
9877,9965,0.89304101,0.90362602,88,0.010585010000000006,I2534,5,77962439,78367092
13277,13435,1.172804,1.18296301,158,0.010159009999999968,I2534,5,113619796,114995781
14973,15373,1.32694399,1.342816,400,0.015872010000000047,I2534,5,127302803,131809316
16849,17123,1.43223405,1.45838296,274,0.02614891000000008,I2534,5,141428100,142615855
17823,17998,1.513394,1.52379596,175,0.010401960000000043,I2534,5,147867479,148657910
20540,20638,1.697276,1.70760298,98,0.010326980000000097,I2534,5,163901888,165059943
20780,20882,1.72984397,1.74415004,102,0.01430607000000017,I2534,5,166464618,167241075
