Start,End,StartM,EndM,length,lengthM,iid,ch,StartPosGRCh37,EndPosGRCh37
446,678,0.022079,0.032741,232,0.010661999999999998,Ust_Ishim_published.DG,5,1499057,1938626
1266,1459,0.064186,0.075794,193,0.011607999999999993,Ust_Ishim_published.DG,5,2809055,3090015
5602,5968,0.23302899,0.249349,366,0.016320009999999996,Ust_Ishim_published.DG,5,10169156,10830474
11355,11739,0.41609699,0.42877999,384,0.012683,Ust_Ishim_published.DG,5,26405853,27950483
13407,14474,0.491889,0.52740502,1067,0.03551601999999998,Ust_Ishim_published.DG,5,32225940,34651789
14585,16069,0.532655,0.56927902,1484,0.03662401999999998,Ust_Ishim_published.DG,5,34861708,38362043
17354,18701,0.59855002,0.61098701,1347,0.012436989999999981,Ust_Ishim_published.DG,5,41263582,50302224
33995,34718,1.027933,1.04630399,723,0.018370989999999976,Ust_Ishim_published.DG,5,94197654,95983469
36886,41531,1.08385897,1.18674803,4645,0.10288905999999987,Ust_Ishim_published.DG,5,103071134,115229725
43439,44103,1.23436606,1.25060701,664,0.016240950000000032,Ust_Ishim_published.DG,5,119275415,121044041
52938,53281,1.47400498,1.48481297,343,0.01080798999999999,Ust_Ishim_published.DG,5,144738057,145746574
