Start,End,StartM,EndM,length,lengthM,iid,ch,StartPosGRCh37,EndPosGRCh37
2168,2343,0.28152201,0.29608199,175,0.014559980000000028,I2534,7,15146113,16540444
2601,2682,0.32558301,0.33719,81,0.011606989999999984,I2534,7,18343723,19064020
3612,3798,0.42456299,0.43764901,186,0.013086020000000032,I2534,7,24908697,25590456
4370,4510,0.47829601,0.49136299,140,0.013066980000000006,I2534,7,28788257,29387315
4733,4851,0.50934398,0.51963401,118,0.01029002999999995,I2534,7,30755583,31116168
6702,6999,0.66000903,0.68027002,297,0.020260990000000034,I2534,7,42098265,43702472
9416,9601,0.81992,0.83223701,185,0.012317010000000073,I2534,7,67241177,68221870
10947,11034,0.97970998,0.990426,87,0.010716020000000048,I2534,7,80873598,81815841
13573,13668,1.18940198,1.20052898,95,0.011127000000000109,I2534,7,105561135,105984496
14258,14515,1.25905204,1.28047299,257,0.021420949999999994,I2534,7,111630670,114587294
17128,17309,1.45437098,1.47562099,181,0.02125000999999993,I2534,7,137089537,138314465
20409,20579,1.84239304,1.86023605,170,0.017843009999999992,I2534,7,157465014,158050807
