Start,End,StartM,EndM,length,lengthM,iid,ch,StartPosGRCh37,EndPosGRCh37
215,347,0.22868501,0.241476,132,0.012790990000000002,I2534,15,25186726,25962058
372,518,0.245216,0.26345399,146,0.018237990000000037,I2534,15,26030108,26538330
683,736,0.29459101,0.30581701,53,0.011226000000000014,I2534,15,27464852,27727209
1846,1948,0.440516,0.45319799,102,0.012681989999999976,I2534,15,34214217,35025496
1972,2062,0.46026701,0.47077,90,0.010502990000000045,I2534,15,35147345,36145547
2143,2273,0.48561999,0.50294101,130,0.01732102000000002,I2534,15,36717869,37856930
2670,2777,0.54472297,0.55484998,107,0.010127009999999936,I2534,15,40290027,40751555
10903,10985,1.10863805,1.11884701,82,0.010208960000000156,I2534,15,91784477,92163797
11418,11483,1.16617596,1.18175006,65,0.015574100000000035,I2534,15,93774439,93972345
11491,11599,1.18209398,1.19283497,108,0.01074098999999995,I2534,15,93986669,94506861
12696,12898,1.35879898,1.37282097,202,0.01402199000000004,I2534,15,100502494,101075498
