Start,End,StartM,EndM,length,lengthM,iid,ch,StartPosGRCh37,EndPosGRCh37
1509,1760,0.072448,0.091344,251,0.018895999999999996,Ust_Ishim_published.DG,7,4379761,5152788
10439,11012,0.40615001,0.418053,573,0.011902990000000002,Ust_Ishim_published.DG,7,22936004,24369144
13943,14768,0.49787199,0.52432197,825,0.02644998000000004,Ust_Ishim_published.DG,7,29652215,31416548
19809,20324,0.66176802,0.67444402,515,0.01267600000000002,Ust_Ishim_published.DG,7,42198560,43293718
24404,25100,0.77446502,0.78536898,696,0.010903960000000046,Ust_Ishim_published.DG,7,52857194,54621134
31132,31557,0.98132801,0.99173498,425,0.010406970000000015,Ust_Ishim_published.DG,7,80971396,82008502
37961,38742,1.15087295,1.17163503,781,0.020762080000000127,Ust_Ishim_published.DG,7,101207035,103622786
41099,41524,1.24319696,1.25389004,425,0.010693080000000021,Ust_Ishim_published.DG,7,109647829,110904226
42492,43127,1.27889895,1.29127896,635,0.012380009999999997,Ust_Ishim_published.DG,7,114014574,116225258
47956,48412,1.38946605,1.40758395,456,0.01811790000000002,Ust_Ishim_published.DG,7,130960827,131879665
50057,50343,1.43748403,1.44790995,286,0.010425919999999866,Ust_Ishim_published.DG,7,135598951,136272383
52519,53409,1.54283297,1.56935406,890,0.026521089999999914,Ust_Ishim_published.DG,7,142014803,145071775
54794,55023,1.61100602,1.621593,229,0.010586980000000024,Ust_Ishim_published.DG,7,148213724,148885877
55656,56023,1.65188503,1.66724503,367,0.015359999999999818,Ust_Ishim_published.DG,7,150610100,151388730
56932,57212,1.73094904,1.75020599,280,0.01925694999999994,Ust_Ishim_published.DG,7,153553064,154151123
