Start,End,StartM,EndM,length,lengthM,iid,ch,StartPosGRCh37,EndPosGRCh37
388,527,0.098798,0.113015,139,0.014217000000000007,I2534,14,22591988,23069700
636,723,0.12789001,0.138165,87,0.010274990000000012,I2534,14,23593442,24020127
1617,1789,0.252581,0.27591899,172,0.023337989999999975,I2534,14,32391209,33485882
3289,3501,0.42775801,0.44324899,212,0.015490979999999988,I2534,14,49017417,50858729
3601,3784,0.45343101,0.46726301,183,0.013831999999999955,I2534,14,51605358,52438337
5011,5191,0.55864602,0.569511,180,0.010864980000000024,I2534,14,60330926,62000216
5580,6118,0.599181,0.62593699,538,0.026755990000000063,I2534,14,65187697,69078074
8880,9060,0.81733,0.83128202,180,0.013952019999999954,I2534,14,86409739,88132761
10951,11058,0.98942697,1.00106001,107,0.011633039999999983,I2534,14,96393767,96740082
12334,12657,1.12063897,1.13751101,323,0.0168720400000002,I2534,14,102153945,104587833
