Start,End,StartM,EndM,length,lengthM,iid,ch,StartPosGRCh37,EndPosGRCh37
1150,1247,0.15932,0.170927,97,0.011607000000000006,I2534,3,6104625,6760499
2072,2249,0.25549299,0.26857701,177,0.01308402000000003,I2534,3,10535771,11054118
3248,3561,0.339315,0.35631099,313,0.016995990000000016,I2534,3,15207209,16868147
4121,4189,0.40656301,0.41704801,68,0.010485000000000022,I2534,3,21870826,22417757
4263,4379,0.42256501,0.43371201,116,0.011146999999999962,I2534,3,23118908,24044400
15508,15635,1.23474801,1.246176,127,0.011427990000000054,I2534,3,113852731,115202972
15798,15868,1.27139497,1.28314805,70,0.011753080000000082,I2534,3,116585281,117172973
16047,16270,1.29506099,1.305951,223,0.010890010000000006,I2534,3,118641879,120137465
17209,17436,1.36546195,1.37603903,227,0.010577080000000016,I2534,3,125845626,126801736
17774,18096,1.39490294,1.41010106,322,0.015198119999999982,I2534,3,128239657,130506949
18324,18546,1.42523205,1.44141197,222,0.016179920000000125,I2534,3,132218623,133555925
20722,20866,1.60800803,1.62054396,144,0.012535930000000084,I2534,3,149374394,150594626
22894,22976,1.77102602,1.78190696,82,0.010880939999999839,I2534,3,171106585,171733624
23935,24300,1.90369105,1.94363403,365,0.03994297999999996,I2534,3,181023400,184093527
26168,26290,2.19828701,2.2146399,122,0.016352889999999842,I2534,3,195531841,196550999
