Start,End,StartM,EndM,length,lengthM,iid,ch,StartPosGRCh37,EndPosGRCh37
1138,1225,0.129491,0.14305601,87,0.013565010000000016,I2534,4,6031632,6315954
1267,1403,0.15129501,0.161397,136,0.010101990000000005,I2534,4,6414398,6744802
5177,5341,0.540555,0.56500798,164,0.024452979999999958,I2534,4,32345280,35255416
6306,6446,0.65942502,0.67093301,140,0.011507990000000023,I2534,4,41653898,42576472
7841,8023,0.77324802,0.79009002,182,0.016841999999999913,I2534,4,58810629,61552659
9678,9816,0.934035,0.945813,138,0.011778000000000066,I2534,4,79536003,81109088
9886,9998,0.95311499,0.96466398,112,0.011548989999999981,I2534,4,82149831,82928896
10176,10319,0.98957902,1.00049698,143,0.010917960000000115,I2534,4,84288272,85136552
11538,11818,1.10813797,1.12567496,280,0.017536989999999975,I2534,4,98923595,101169892
12903,13046,1.22342503,1.23510098,143,0.01167594999999988,I2534,4,112521730,113964288
16156,16312,1.52189398,1.53546,156,0.013566020000000067,I2534,4,148468943,149690402
18132,18394,1.71817601,1.74727297,262,0.02909695999999995,I2534,4,167154697,169764312
18709,18873,1.77918398,1.79781604,164,0.01863206000000006,I2534,4,173513934,175009881
19090,19283,1.83625197,1.86002004,193,0.02376807000000003,I2534,4,177348069,178817591
20640,21157,2.05972004,2.13196611,517,0.07224606999999983,I2534,4,187135331,190467123
