Start,End,StartM,EndM,length,lengthM,iid,ch,StartPosGRCh37,EndPosGRCh37
668,790,0.075229,0.085601,122,0.010371999999999992,I2534,6,2898596,3374575
1370,1446,0.13697,0.149443,76,0.012472999999999984,I2534,6,5571672,5905459
4852,5056,0.459097,0.47196901,204,0.012872010000000045,I2534,6,24584366,25476552
7389,7934,0.49946401,0.51043999,545,0.01097597999999994,I2534,6,32019769,33004287
10723,10867,0.69091803,0.70263398,144,0.01171595000000003,I2534,6,45768003,46613083
12166,12335,0.78212899,0.794631,169,0.012502009999999952,I2534,6,57535593,65940233
14030,14264,0.90947598,0.922149,234,0.012673020000000035,I2534,6,83621651,85761559
16063,16209,1.07056499,1.08545196,146,0.014886970000000055,I2534,6,102641969,104730306
20852,21052,1.46382499,1.47727299,200,0.013447999999999904,I2534,6,143004966,144042059
21698,21823,1.52690899,1.540483,125,0.013574010000000136,I2534,6,148836977,149381881
21936,22095,1.54424,1.55554605,159,0.011306049999999956,I2534,6,149918284,150704465
