Start,End,StartM,EndM,length,lengthM,iid,ch,StartPosGRCh37,EndPosGRCh37
354,498,0.039658,0.054996,144,0.015338000000000004,I2534,9,1506101,1979053
2005,2109,0.22371501,0.23667599,104,0.01296098000000001,I2534,9,9483287,10277054
2118,2246,0.239586,0.255144,128,0.015557999999999989,I2534,9,10374705,11806107
2447,2636,0.28361601,0.30260599,189,0.018989980000000017,I2534,9,13520190,14292640
3115,3293,0.354673,0.36819199,178,0.013518990000000009,I2534,9,16661933,17843521
3704,3849,0.40505299,0.418167,145,0.01311401000000001,I2534,9,19904103,20793269
4063,4122,0.438438,0.45057601,59,0.012138010000000032,I2534,9,22617269,23423892
4144,4234,0.45518899,0.46539599,90,0.010206999999999966,I2534,9,23557134,24336107
4881,5107,0.55115801,0.56537598,226,0.014217970000000024,I2534,9,29831268,32207510
6876,7077,0.70372301,0.71758002,201,0.013857009999999947,I2534,9,75083095,77227302
7187,7368,0.73145598,0.75508499,181,0.02362900999999995,I2534,9,78068839,78908826
9011,9258,0.90603203,0.925735,247,0.019702969999999986,I2534,9,89741433,90835726
9664,9922,0.95853502,0.97204602,258,0.01351099999999994,I2534,9,93028943,94121330
9982,10425,0.97688699,0.99433702,443,0.017450030000000005,I2534,9,94420140,96910612
10822,11132,1.012622,1.02544498,310,0.01282298000000015,I2534,9,99489854,101137452
13519,13657,1.21478796,1.22573698,138,0.010949019999999976,I2534,9,116170559,116780465
13935,14169,1.24315906,1.26086795,234,0.017708889999999977,I2534,9,117541450,119002278
16454,16682,1.424052,1.45199001,228,0.027938009999999958,I2534,9,132351440,133408125
16697,16938,1.45531201,1.475788,241,0.02047599,I2534,9,133531780,134641427
18128,18259,1.62416697,1.64118505,131,0.017018079999999935,I2534,9,139016326,139828624
